 |A B C D E F G H
-+---------------
1|. . . . . . . .
2|o . . . . . . .
3|. . . . . . . .
4|. o . . . . . .
5|. . . . . . . .
6|. . . . . . . .
7|. . . . . . . x
8|. . o . . . . .